疲劳	症状-体征
心悸	症状-体征
气喘	症状-体征
胸痛	症状-体征
胸骨后疼痛	症状-体征
心前区疼痛	症状-体征
胸痛连及左肩疼痛	症状-体征
胸痛连及左臂内侧疼痛	症状-体征
胸痛连及左无名指疼痛	症状-体征
胸痛连及左小指疼痛	症状-体征
胸痛连及颈部疼痛	症状-体征
胸痛连及咽部疼痛	症状-体征
胸痛连及下颌疼痛	症状-体征
胸部紧缩感	症状-体征
心前区紧缩感	症状-体征
胸骨后紧缩感	症状-体征
胸部压迫感	症状-体征
心前区压迫感	症状-体征
胸骨后压迫感	症状-体征
心前区烧灼感	症状-体征
胸骨后烧灼感	症状-体征
胸部烧灼感	症状-体征
胸闷	症状-体征
胸痛持续数分钟	症状-体征
胸痛持续十几分钟	症状-体征
呼吸困难	症状-体征
咳嗽	症状-体征
咯痰	症状-体征
咯血	症状-体征
夜间阵发性咳嗽	症状-体征
端坐呼吸	症状-体征
咯白色将液性泡沫痰	症状-体征
痰中有血丝	症状-体征
咯粉红色泡沫痰	症状-体征
乏力	症状-体征
头晕	症状-体征
少尿	症状-体征
心率加快	症状-体征
腹胀	症状-体征
食欲不振	症状-体征
恶心	症状-体征
呕吐	症状-体征
肝肿大	症状-体征
肝区压痛	症状-体征
脚肿	症状-体征
踝部水肿	症状-体征
小腿肿	症状-体征
腿肿	症状-体征
血压	监测指标
收缩压	监测指标
舒张压	监测指标
尿量	监测指标
24小时尿量	监测指标
呼吸	监测指标
体温	监测指标
脉搏	监测指标
心率	监测指标
血氧饱和度	监测指标
呋塞米	药物
托拉塞米	药物
氢氯噻嗪	药物
螺内酯	药物
氨苯蝶啶	药物
阿米洛利	药物
卡托普利	药物
贝那普利	药物
培哚普利	药物
雷米普利	药物
咪达普利	药物
赖诺普利	药物
氯沙坦	药物
缬沙坦	药物
厄贝沙坦	药物
坎地沙坦	药物
替米沙坦	药物
伊贝沙坦	药物
诺欣妥	药物
雷米吉伦	药物
依那吉伦	药物
阿利吉伦	药物
美托洛尔	药物
比索洛尔	药物
卡维地洛	药物
阿替洛尔	药物
索他洛尔	药物
普萘洛尔	药物
地高辛	药物
米力农	药物
氨力农	药物
硝酸甘油	药物
单硝酸异山梨酯	药物
奈西立肽	药物
左西孟旦	药物
伊伐布雷定	药物
托伐普坦	药物
阿莫西林	药物
头孢	药物
华法林钠	药物
阿司匹林	药物
外用糖皮质激素	药物
卡泊三醇	药物
哈西奈德	药物
他卡西醇	药物
糖皮质激素	药物
蒽林	药物
维A酸	药物
煤焦油	药物
松馏油	药物
糠馏油	药物
黑豆馏油	药物
他克莫司	药物
吡美莫司	药物
他扎罗汀	药物
焦油	药物
维生素D衍生物	药物
外用皮质类固醇	药物
卤米松	药物
消银片	药物
丹青胶囊	药物
糠酸莫米松	药物
甲氨蝶呤	药物
维甲酸	药物
阿维A酯	药物
阿维A	药物
环孢素A	药物
霉芬酸酯	药物
依那西普	药物
益赛普	药物
青霉素	药物
头孢菌素	药物
红霉素	药物
酮康唑	药物
复方青黛丸	药物
雷公藤	药物
复方丹参片	药物
英夫利西单抗	药物
阿达木单抗	药物
乌司奴单抗	药物
哈西奈德	药物
哈西纳德	药物
蒽林	药物
煤焦油	药物
松馏油	药物
丹梦	药物
丽泉	药物
丽芝	药物
乐泽	药物
代文	药物
伊缓	药物
伟特	药物
佳择	药物
佳菲	药物
依双	药物
依苏	药物
倍尼	药物
倍怡	药物
倍悦	药物
兰沙	药物
兰谱	药物
凯络	药物
博苏	药物
博通	药物
叶酸	药物
吉加	药物
喜善	药物
圣畅	药物
坦释	药物
复欣	药物
天易	药物
妙林	药物
妥尔	药物
安亚	药物
安来	药物
安适	药物
山坦	药物
希佳	药物
常平	药物
平欣	药物
平至	药物
康可	药物
康楚	药物
德茨	药物
思泉	药物
怡方	药物
慧源	药物
托平	药物
拓赛	药物
曲亚	药物
林平	药物
枢衡	药物
格平	药物
欣平	药物
欣蕊	药物
洛雅	药物
爱络	药物
畅泽	药物
畅苏	药物
百畅	药物
益恒	药物
福坦	药物
科苏	药物
穗悦	药物
立文	药物
素定	药物
缓宁	药物
缬克	药物
美斯	药物
脉欣	药物
舒梦	药物
舒通	药物
艾格	药物
苏亚	药物
苏纳	药物
苏适	药物
若朋	药物
获平	药物
诺释	药物
赛卡	药物
赛坦	药物
邦坦	药物
金络	药物
雅荣	药物
万伯安	药物
久保克	药物
伊泰青	药物
伊特安	药物
伊达力	药物
伊迈格	药物
优布丁	药物
佳宁诺	药物
使尔通	药物
依伦平	药物
依康宁	药物
依思汀	药物
信立坦	药物
信达怡	药物
倍博特	药物
倍迪宁	药物
倪利安	药物
健朗安	药物
克为德	药物
利来客	药物
勤可息	药物
博欣舒	药物
博脉舒	药物
卡理稳	药物
卫信宏	药物
可兰特	药物
喜安林	药物
嘉瑟宜	药物
因弗尔	药物
坦芯素	药物
埃利雅	药物
复代文	药物
奈迪亚	药物
奥必欣	药物
安内喜	药物
安内强	药物
安利亚	药物
安利博	药物
安博诺	药物
安明松	药物
安泰达	药物
安维乐	药物
安维喜	药物
寿比山	药物
尚尔宁	药物
尼德舒	药物
山益新	药物
希尔达	药物
帝益洛	药物
康达欣	药物
开富特	药物
开搏通	药物
心达舒	药物
必利那	药物
怡欣坦	药物
怡那林	药物
恒雪素	药物
悉君宁	药物
悦南珊	药物
悦宁定	药物
抑平舒	药物
拉美亚	药物
捷赐瑞	药物
搏力高	药物
文乐宁	药物
斯泰乐	药物
施太可	药物
易达乐	药物
易集康	药物
星复康	药物
普乐欣	药物
普利宁	药物
欣可通	药物
欣宇森	药物
欣洛平	药物
欣益尔	药物
欧美宁	药物
武都力	药物
毓乐宁	药物
沙丁宁	药物
沙泰齐	药物
波开清	药物
洛格乐	药物
洛汀新	药物
浦美特	药物
海捷亚	药物
澳已新	药物
灵广利	药物
特立康	药物
特苏尼	药物
特苏敏	药物
瑞欣乐	药物
瑞素坦	药物
甘悦喜	药物
百安新	药物
百普乐	药物
益迈欧	药物
科什兰	药物
科素亚	药物
立君宁	药物
纳催离	药物
维尔亚	药物
维尔坦	药物
维易洛	药物
美利巴	药物
美卡素	药物
美嘉素	药物
至信风	药物
舒尼亚	药物
舒络宁	药物
苏麦卡	药物
蒂益宁	药物
蒙得康	药物
蒙达清	药物
诺亚特	药物
诺适美	药物
诺金平	药物
贝奇力	药物
达舒亚	药物
迅可安	药物
远斯坦	药物
迪之雅	药物
迪赛平	药物
速平青	药物
金捷妥	药物
金缬克	药物
阿西亚	药物
隆舒雅	药物
雅施达	药物
雪盈平	药物
高易消	药物
三氨蝶呤	药物
丽珠维可	药物
亚邦恒贝	药物
依普利酮	药物
依普沙坦	药物
依那普利	药物
倍他乐克	药物
凯宝压苧	药物
双赛普利	药物
吲达帕胺	药物
喹那普利	药物
塞利洛尔	药物
天泉乐宁	药物
奥美沙坦	药物
安普诺维	药物
布美他尼	药物
帕米膦酸	药物
平克亚欣	药物
托西尔康	药物
拉贝洛尔	药物
氨氯地平	药物
氯沙坦钾	药物
沙库比曲	药物
泰纳普利	药物
福辛普利	药物
纳斯力妥	药物
艾司洛尔	药物
螺内酯片	药物
西拉普利	药物
贝凡洛尔	药物
阿尔马尔	药物
阿罗洛尔	药物
麦道欣宁	药物
东药心泰恒	药物
依普利酮片	药物
奥美沙坦酯	药物
巯甲丙脯酸	药物
福辛普利钠	药物
阿利沙坦酯	药物
叶酸依那普利	药物
坎地沙坦西酯	药物
复方卡托普利	药物
复方阿米洛利	药物
盐酸普萘洛尔	药物
盐酸艾司洛尔	药物
盐酸贝那普利	药物
盐酸赖诺普利	药物
富马酸比索洛尔	药物
缬沙坦氢氯噻嗪	药物
苯磺酸氨氯地平	药物
酒石酸美托洛尔	药物
马来酸依那普利	药物
卡托普利氢氯噻嗪	药物
厄贝沙坦氢氯噻嗪	药物
替米沙坦氢氯噻嗪	药物
赖诺普利氢氯噻嗪	药物
复方马来酸依那普利	药物
琥珀酸美托洛尔缓释片	药物
